*********************************
*								*
*								*
*								*
*								*
*								*
*								*
*                               *
*                               *
*********************************